carfax=informação de veículo
map=mapa
search=busca
search2=experimente buscar em
uses=usa nosso
syntax=sintaxe
more=mais em
more2=mais
top=topo
official=site oficial
password=senha aleatória
number=número aleatório
random=aleatório
entry=artigo em
web=links da web
web2=experimente links da web
mean=tem vários significados
meant=clique no que você quis dizer com
meanings=significados
meanings2=alguns significados
dictionary=dicionário
package=rastreamento de encomenda
ip-go=tente ir lá
parked-domain=é um domínio estacionado (da última vez que verificamos).
area-code=é um código de área em
zip-code=é um código postal em
phone-number=é um telefone em
reverse-search=busca reversa
pay=pago
free=grátis
results=usa resultados de
results2=resultados de
topic=nenhum assunto correto?
topics=alguns assuntos agrupados em
topics2=mais assuntos
topics3=assuntos
sections=agrupado em seções
and=e
links=mais links
related=assuntos relacionados
related2=mais assuntos relacionados
at=em
ignore=por favor ignore esta caixa
put=digite os termos de busca aqui
settings=configurações
goodies=extras
spread=abrir
add=adicionar a
region=de qualquer região
ducky=confio no pato
sort=ordenar por data
popular=popular
programming=programação
images=imagens
news=notícias
zero=informação sem clicks
requires=essa página requer
version=obtenha a versão sem JS
here=aqui
category=categoria
